0 0 0 0 0 0 0 0 0 0 0 0
0 10 10 10 10 10 10 10 10 10 10 0
0 10 20 20 20 20 20 20 20 20 10 0
0 10 20 30 30 30 30 30 30 20 10 0
0 10 20 30 40 40 40 40 30 20 10 0
0 10 20 30 40 50 50 40 30 20 10 0
0 10 20 30 40 50 50 40 30 20 10 0
0 10 20 30 40 40 40 40 30 20 10 0
0 10 20 30 30 30 30 30 30 20 10 0
0 10 20 20 20 20 20 20 20 20 10 0
0 10 10 10 10 10 10 10 10 10 10 0
0 0 0 0 0 0 0 0 0 0 0 0
